11111111111111111
100000000C00E0001
11111111111111111