11111111111111111111111111111111111111
100C0000000000000000000011111000000001
100000000000C00000000C0CC11110CC000001
10P00000000000000000000011111000000001
100E0000010000000000000000000001000001
11111111111111111100000000000001000001
1000000000C000000000111100000000000111
111110000000000000C00111000000C0000111
11111111111111111111111111111111111111
