11111111111111111
1000000P0C00E001
11111111111111111